NO ./texture/bluestone.xpm
SO ./texture/colorstone.xpm
WE ./texture/greystone.xpm
EA ./texture/purplestone.xpm
F 110,153,15 
C 255,255,255

        1111111111111111111111111
        1000000000000000000000001
        1100000000000000000000001
        1000000000000000000000001
111111111000000000000000000000001
100000000000000000000000000001111
1W0000000000000111111100000001
1000000000000001     100000001
1000000000000001 111 100000001
1000000000000001 1011100000001
1000000000000001 1000000000001
1100000111010101 1111011110101
11110111 1110111 101111010001
11111111 1111111 111111111111
